%%%%%%%
%     %
%  P %%
%     %
%%   %%
%. %%%%
%%%%%%%
